I1I2I3I0L1
I1I2I3I0L1
O2O3I1O0O1
X2I1X1X1O0
I1I1I1I1I1